fqt: bzs
pbl: jkk zmp
vkq: lqr
tlk: jcs ddq nkt vfh
hhp: qlf
zxv: jxj vlm fmb mpm
qtg: vzg
bxf: ddb lxs rfq
zqt: nkt mxj
jxd: zsf rsk hfk jnp
hsx: nhc psx jtj lkt
rts: thb
czc: lhf fmz rnq hkq
jcs: lbs nzh
rzm: rpf ntt lgs
ntj: fkd mbh bfr qxz
lsx: xdf msv kxx tjn
hsp: hcb ptz nzs dpv bdf
bdv: zbf spp zzj tzz
jbm: ggk
xqx: pjf fts bcv ssc
mlv: psz fcs djx vbt
src: fhv stv lzg qnq
jrk: pmv kqx nll xsj lhf
hkx: hxr bhf
prh: pbn
xkg: hcn hcg prf
ttg: dgl mxg fpc
dql: gtc
zxs: pxq xnv rcf zrv
dgb: lfm kzx vzg nll
fhv: pnv
bnh: mbc
rrz: jxj rpf bnk pgn
jjd: gxt mcj
fxg: zxj
shg: dpk tnr vtn
zzf: nzh
zqr: fkr tzr
zmp: krh
xqf: srs gsl
nvb: dcf msn fts
qsn: bhc jmc nmz
hbq: qxz
qkv: kpd chd
mfg: chz ddb vtl
vgx: cpd
csd: mzq
jhf: ztb rrf gqm
xbg: vzd qgg gpj
fjn: nmg fdh bdh hzk hbq
qtf: tcx hhp zvx
jmc: qcz
fmb: jxj
dsz: ppt
dpl: gjf
bxb: fmh fkq gxp
prd: ghh lmq
gsq: zvx fmb
gxf: kkr pkh vgv pjm dnf
fzd: jfj lxb pnh
vkk: dsz
hqx: djm
zrj: vbt lch lrs dqj srv
thh: vgv zbx qmj mgd
ccj: qvb
hbc: tkh
pgr: jxz vbr xxs rjp
mkg: jgq
xnd: dng bpb
rbl: znp ksx
ddq: djm
zxz: ljg lrs
vtj: ltn ktl kxt
ssf: zfd njn mxv jtj qxf
ksx: bxp
zhg: pbl phs
szr: hnc qhh stv rrf
kmz: bsb lcb
vfh: jgq lvv tjg vms
tvx: ztq mfc
jpq: nbj xxv dnf fnb
qxf: rhd
jdn: rcb bvm kmh
zst: mfn prr xcv
qrz: bll pgz
hqj: nll mjv gck pqg
vzh: dxl xqg lqr
dkm: vth mxv vcz bnq zdv
tmd: trt krn pzv qgb
vvn: hbs ckg
tlh: skp zbl
qqp: lgj
shz: pvn
tjs: ljl trz hls
qqg: bhf cns fkq
kzl: zvg jtg
xcl: xqg dhp zzf rjq bhb
mtq: qpb fbc rhn
xpn: cds
ssm: pbc qln cjt npk
drm: bll rhh
jjx: zfg msm ndc
phs: csh
ftr: tff tst xnj
pfb: hcl zgq
spk: lhh bgn lbs
cpf: vgn tbc
cxh: hcq gst jdm jxx vps
sfj: ffq fqt dxp
klk: bbv lqr
zld: xpz gbr ssc zql
klv: shh tqh kpl
xnn: czl xcq nfl tbx
csc: bsj bhj zlc
fpm: rns xdz xdh shz
nfc: jvx chm ccd qtx jbm
bjk: hbh
lqr: dsx
klz: bvm cmz
sdm: gxt vdr gjf
tvh: vkh hrv
qhh: gzd ztm kpd
ssl: cpd pqp kks
cmf: vgr llz
zjf: zpl gtg lpp kkq
tpl: znp plb psx qpg
kvh: ghh zxz jvx
ghl: rxd rxn qdq vjv mbq
hbg: xvt pjv
ztm: xxl hsp nzk frh
llz: kfq
mpx: mxj fjm rhn
vzf: nss nzl kdg xft
vjb: nzm mgv kcr xhj
znh: lhm mzm zpx dpf mdv
lnf: xfc hbs vdr
qsf: pqp
xgn: vkf tpt hnc
cdt: zgm zgd
ncg: psx czp
bbp: nzk rhv ggt jgc
shv: lkt rpd fpc dqf qsn
cts: kgj xft mcj tgg
zhk: kqr qlf qgm
ldj: qzh rxc lkt nzs qjh
pzj: xft
rfq: qlg
zcj: dgl kzl nmc mpb pzg
tkv: jtj jnj
pth: jbx lcs dld bzv mgj
dxg: jgg trb vlh sfn
kpf: pnb
hmq: qxn mfn
hcb: hnc mxg hrd
vgn: tsp bxm
qpq: hjh lhf
znm: xrl
hht: xtm mvx
jqv: qln xrv hhp rzn
mxx: xbt
xhv: hds snt
qfz: xxr fnb
mht: fbc
rcf: sfn
hgp: djb pnh tqh jfp llr
stm: hkq znz fgs sdp
mfz: vrs vxn xdr qdr zxl
rfh: nfq vkf bvm
hvl: stv
jrq: mlf gpj bhn
lss: srv bfh
rqm: zgz
fvg: gjb fxp skp
rdq: crk nmf mfg
qhn: sdf
zhr: jmh jvx pkb
rfp: pjv jnf kgj
flt: zhk ggt bnk xcn
jtj: bjz vtm
qfl: xhh lhj ptz
pvz: fcf
bnv: bml rhd
rrf: dlm cbv
jpd: klk sxv kvh pcb
xhk: vcr gtc cmf pnd mgj zhm
tfm: kvt dgc
rdh: gmz lbc ksb nzq
msz: zkb nfb
dzm: cvj ksx trl lxs
krm: tnf zsf crs ftp
gfd: bkb rts nlg
tzz: vhf
kkm: dtr kpl brq
xgs: jcs hkx mfh mbh kbs
kzx: bfh crp flq qmr
jhq: kgj dsd tqq jjm
vng: hgr sdm kmf xxv
fdh: bnh qfz
rzk: vfb ppc qfp
tsz: xhn gsl mkh bdf
qzj: pnz rpf tkd crj
qxp: glt
scv: mvx ghv vzl stp
trl: znm
znq: qxp cbv
psl: lnm vcp llr bbq
lpc: kxx
cdp: lcb knr qqp
mnh: vfn rcb bcv
kfp: vrs bjb
fhr: rpb jmr
lfm: kbs ktl
xdl: sbs tjg crp
vms: vzg xjn
zzm: fmd jtj jtg nzk nxx
fnb: lnm
hct: fxq sjk tjq mdk nzl
sld: hzn
ckv: tnf
cdd: mzn tsj dqz rzn
gfl: pjm tgg
rdm: tmx
tzr: rdb
gpp: pkj glb lqh tss
lbb: xfc spp
zrc: zpl zxl skm tmx
prf: pgz
ddz: prh
fkc: rqx skp nfl
gmf: zhg jql tkv crk
gnx: phs
mgj: rgs zqv cfk bzm
kxj: rbj hbh
mrj: pqp zqh tbv
tff: vgx hjx
xpz: vpj
qcp: rmm ndq hbg
nxx: qbh
fbt: xtk jqv sqb
kvt: xph
lhj: cpm jtg
pzm: fxb vfc tkf ppc rqz
xvv: xtm
lxn: bjf fvz ccj
jzh: fmb nmd snr gmz
cvf: jtr zvx xpp bhn
hmh: glt sld tqd
dpt: qlf ckv cgx pfm zvg
fdd: hcg zhv jnp zfd
mjk: zlq
tjb: mht hvm srv
ssk: rhh jxx
hzc: qxr pvf
kfs: srv
nbv: fxp hnt fdk bxp vjt
sgm: gbl jrq vkh mhg
tkd: vtl
jxx: vjt
kps: cdt mjq tsf
blc: vxn
vzd: bll
khh: bml djc
lgs: tlh nfs csh
qpz: lnl fjh vzl djq
gmj: xbz cns
kfn: pjm lrs dlj hlx gxr
jjm: dql
gzk: llz fjm
cth: gmn
mfn: stb
xxs: xtk zqh pqm dvg
sfs: jtr cjt
ldk: kxj pkj pbq
jjj: sfd thq hrt
rpp: zgm tvh
vdb: nmd xgv ckv
mlt: lpp cnn
ztb: bnk rbj bjz
xkb: fqm
nfs: cgx
zqb: skv
gxt: bbq
vlq: nzq bjk stp
hkj: rzn mlf gbn zdv
rqz: jht
bps: vkq gxc ctc fcf
xjz: vxd gnj
hbh: svm
xpl: tjb lbb
fhl: qkx fjh
nzc: jrc xrm
xcv: sjz fgs
dxl: lfc jlb nzh mjk
kcc: bmp xgh dlj vkk
hqp: vbr xpn lxx qzn mxv
mmv: ggh prr
zbx: xfc xql
lqg: lzv ppl pcv
ncp: xnf smq ktl mfh
mzq: srv
kgd: nrt dhp gxc kkm
xvp: chs msh qnf
gxp: zcb vgr
qgb: fjh
mzn: xtm
rft: frq tjg qcp lbs
tbn: mxx sbh vxd
nmz: ckt vht vkf shg
tpf: rjq lxb jmh zhm nrt
vdq: mfh
qkp: kmh pqm
kpb: hfd mcj dqb rkt
tct: smq xbr
vbb: tlb mpm
jxz: lhb rpx
tzd: qct rxc plq
jgp: clc bgb mbd
zgd: pfm
fsc: jtc rdb dtf vdr qmj
thv: cnn xqg tzz rnt
gxr: fdq mzq jpr
sng: prh pkb pzt pbn
xgh: rqz xql gtc
dqn: gqm pzn lnq lxx
xsx: qxx
qbz: zsf
hps: trs jfc qgb
nxh: xkb hmc
tjq: lmq dtl gfl
sgz: ttg tpl sbm dbd kcm
hpp: tzk dxn mjc dqb
ztd: brq jjd
jmm: qnf zpx hbz
zvn: lqs zfg
jgs: xxt ggh cdp xfn
xhh: gcx tqd dlm
tdh: nfs
dbn: ffq xph ghh
gpl: rfq
cmz: rhd jtg
xbr: xph xhr
hxq: sfp rpf pzg pgn vmb
nnr: kpg xcr hgr
sqp: mjv bjb jbm
crs: qgb
snv: mxx
pnz: nfs
qjx: qxf sbm
lnq: nxx fhr
gkr: hrv ptf
xbk: jmk
rnt: lpx jmj zng mnk
sbg: jjz xtm djc qcz czp
zfd: klz
xgd: mss
gbn: trs jjz vkf
xbc: frf vfb spp vvf cth
lqs: vpj
pps: qpv ngg qjh
grd: rql tkd cmz prf
mfc: kxt
fcs: kvt jlb
gdv: jnf bfr
fdl: pln hrd pnv tss
hhs: qtx kkr mtq
mhf: fnz nzm zmd tbs xtm
rgd: dqz rfq hht xtk
vfb: kqx fdq
nkt: jfp dsc
fnz: bcv
jmk: qkv
mdq: hnt qln rcb
ppk: jpr spx
jtd: gfd nsh vcp dtl gtg
nfb: vtl
rxd: qrz xqf mxp
bmv: khb rvq
xtc: pgn
chd: knk
xpf: kfq tgg
msn: ggk jfj mfh
bgb: llr dsx
dxr: hkx bzs chm kmf
vml: cfk
pdg: bbl
vps: dzf mtl hbh
fxp: tzg lxx
mzf: pbl tnf vlf
dqc: vgv xfn jfp thj
lzq: btj knr qhn bgn vqp bsb
kpl: xhr fmh ljg
mvf: cjs nsh dfb chm
rgh: bjb
pvn: mlf
qjt: llr
tzp: vtj
rbt: rnn bpz mlc vkc jhd rsk
trt: ccj pkm
bzp: rjd hmh fvz
rnc: kgz pqm rdh dqn
mtc: pfb fbc tcg zcb
tlc: qhn cnd fxb
sqs: fmz qkd xjn
skq: pdg nzq zhv
vjg: vjt jhf xbk
cbn: tqt pxq
rns: jtg vmb hzb pqh
xpm: csn vjv lbc jxj
tgk: rtg qnp tzk nhr
lhh: zzf
lbh: bpb lzh
qmp: pzt dcb srv vgf
chz: qjh
mrl: ssl qzn glb lhb
jpm: jpr tpn xpl
nzm: kfj xdg qgm
skm: vkq njz kfq
cqb: gpl bpm qsn cpf
hgd: gnr kgz vbr lxn cpm
ppr: xqx njn lhb mgx
tlb: nzc shg lhb gjb
xqt: fkr rlq
chm: rmt kkr zjr
skl: fxb tpn rcp psl
hhj: ljg
rdn: fzd tfm vdq hbl tcq
zkb: vtn tsp
csh: rhd slv
cfk: lfc ppc
lqh: szx csq tcx
fbd: kgj mfp
dgl: cgx
qrn: tjn xsz tqq nns pth
cxk: qfz klk
tjk: hds dnf jht
qcx: mhd zmq qsf
bhf: dxm
xxt: bxl pxq ccd
nsc: gxc mbd xqt smg
tqq: tvx hls vlh
sbh: ktl hgr
zrr: dld mdv xrq pcb
xgm: xtc srh qxp khr cvs
qdq: tnf
jfx: nxh sqs dsz nlg jqh hmq
mxv: ptf
cfg: xqz zzf khb lss
ndq: kkq klb sfj gcg
mlf: thf
nzl: pgx
qmj: qxr
mgx: vjg xbg rzn fbj hbx
kmb: qtv mdv
ppl: mcv qnf
vqp: hph vxd xbz mjc
hbl: kfq rjq fxb kmb
rtm: ckj
hxr: snt
mjq: ckt hfk
jdg: vdr hph bmp
vth: gmz kgz
kqr: tkv ghv
hbt: fcc jzf zhr cjs
ksg: jqs
mxq: tfc
nrf: tdh xpz npk mjg
zxq: zlq
frm: ggk
xfr: glt
vhj: vsb xbk pkg dqp
jzf: ngz pkh lfc
mcp: sjz jjl lhm zqr
khb: sfd
cjz: qtg pnb xjf
gtm: fmd qkp
snc: qdp pst cvs bjk tbx kps
zqv: klb jpr jfp
fms: kcm mzn hgx
rdj: tkh fxr
lxp: qtv vsq xhr
plq: rzs xrv
fkf: mtr lzh
zjc: pgv prg tjb pzj
ddh: qlg
lzp: hbg dsd ztd zxj
mtp: rcs pbq tmb
jfc: jjz
jgq: mzm
dld: thb djx rdm tcg
mkv: mrp pzn qgm fpd tff
blb: bmv vbt gsz
cxb: hbq vvn brq rft
vch: drm
zbl: hrv
nhr: qxn tqt xxr
llr: vcp
thb: clc
grl: mfn ppt vzb
pbq: hhp pdg bdf xbk bng
qkh: fmd zdd hfk kks
hbx: mhd qlf klr txj
ngz: trb gzk
msg: xnv fdq zxj
xft: msh bgb
sxv: flq bcs dng jcx lnm
ndv: xqf hbc jtr svm gkq
bgl: vfc zhm nss cbn
gkv: vbb pln shg
pkg: vtl nln rcs
hcn: nmd
xgj: tqh fbd vml
dbd: xgv
kbs: fmz
qrt: mzm zsn
qff: jnf
ggh: tfc mqh xdr
lhz: mbd qtg
trp: xqg zqr
pnd: dkh cxl
hmt: pqp grx txx zbl
gxc: tqh rzk
vkc: lcf
kgk: zfz kfs rcp bkr tct srv
zdv: jkk
qnq: gzq rqx pqp qkp
lrs: kpf qxr
qmr: gcx
lzl: vjg gnx tsj tzx
mjg: hsx xvv mqd crc
jrp: zcl tbn kvm vml lvv gck
jkf: xfr qcn rcs
cfn: gsz dql djm
smg: bgn bjj
zdj: rfp bjj
bbj: nrh fpb xdr nzl rnq
sbs: cnn thq nbj
ngg: fts cpd tkd pkm
dss: qnz ssv pbc
fpd: vzl
pqh: mtl hcv dbd
smx: zdj xfc
bcs: qjt vsc vlh
bhs: rrf crk ntt dbd
jtc: bjj
pvc: srh mfl znm csn
qfh: lzg qpv bxh znn pkj
bxp: zfg
lcm: stv
xqz: ppt
xpt: hhj qxn kfq zxl
dgc: xnv jdg
htk: nxx fhl nxv shz mxp
fzg: tzr kzm msv rdm
dvg: bng
thz: xbg xgn rqk pgz
nlg: rsq mxq fkr kpg
qtv: kgj
jxc: glp tzr cth
glp: sdp kxx xtd gtg
mdk: rts xcr kpf
qmb: bhx ghv kfj vkc
bkb: gdv
jpf: jcx ztq
lrn: qsp jrq
qfr: sqp fmz
ttc: kvb crp zsz xsj
cjs: llz ktt
vrc: ccb zbx mxj
gdn: tpn
bng: ddb
dkh: zxj djx
pgx: xsj pmv
rcp: dlj rcf
qbb: qzh vkf tzx jjx glh
qtb: lpx ckj pbn
tnb: ztd grl bkb
fdk: ptf
dzp: hqj zqr ppk lrb
fpc: fxp pfm hbn
mxg: hrv
jdk: nxf jtk xfr
nns: lcq xkb fqt
cdj: qxx vht krn jfc
qfp: cns hls znz
sjk: dqm
rdk: hqn rcp shh
fpj: mxq hfd pmv
ccd: qqp
hpf: rvq dxm qrn sjz
pcb: xnd
gvl: tjn tcg hqn svn
ngr: pln qtk xsx
lxb: gdn
ffq: pkh fnb
tgv: vhf mcp klk lbh
ztq: smq
fvz: tlm
gqm: xfr
tst: qbz jxx vpj
qzr: fhv npk lfg zsf scz
nkh: fkf srv xpl qjt
hhl: cpf lqs
hvm: znz xfc
pmp: tfm msg bxl mcv mpl
zgz: gcd znz dnf
dsd: kpg
psn: gjf fkd
xbz: hds bhb tnb
xlv: fms gnc nzk vlq xpn dpv
rsk: tkh
qdl: zbf klv xsz fjf
pdf: rns sqb bhn
vzv: cjz ppt khb sjk
pzg: bxf jrc
lgk: mfc mtc sgh ndz tvx
nxr: jfv klb xsg pjz kpg
vrk: ssk ptz ggt
nss: nzh hhj lcs ffq xxv
rjd: ggt
flq: bzs
lnl: pps
cxr: zfz lrb hhj
mjv: frm
jcx: ghh lcq
vsk: kbs xqg mcj
nkc: bzp ftr hzb jnj
xdr: jjl fxq
vsb: fxr
plb: pfm qln
gzd: qxp znm
vkb: lfm bfh
fkq: pcc fkd
rlf: vgx zfg
skv: mfn stb xsj
bkr: jqs kqx fjm
sdp: pbn
hgx: lfg lqs rdj crk nbk
djq: srh tzg hvl
zlq: tpn
mgd: blc lst xql
xhn: crk zvn
pzn: skq tcx zmp
xnv: kxt
blg: pdf ggt fhr vvl
pkj: crs
ctc: fjf xjn cnd
kqm: spx dtl ppl lpc
vvl: qdq
rgs: vgr
hdq: xcq rdj jxz pms
jfj: lmq lgj
qpb: snv dfb lhf
vlc: bhn krh
lqx: msh bpb rgh
xdh: zfg vmb
ppm: tnr dlm xrv tbs
dxm: qtv mjv qfp
jcp: trs tsp khr pvj
dtl: xmh
pms: vht vtn
vtm: kpd
fxr: slv
tzk: ztq lcs
skf: ngg msk dlm
cnx: snv
btj: cmf sdf rmt
fvd: spx hzc
mrp: zpg mnh lcm
zrv: ppt vdn
ktk: mkh ggm tqd ftp
pjv: lzv
pqg: fqm nnr tlc
mxp: zgd mrp
jqh: sgc hbs
zlc: xsx dss
dnk: kcc mfh lzq
bcv: scz
qkx: jtk
pxc: ftr bnv dqf jkk
ggx: xbd dpl jfv vlh rmr vfc qqg
vrs: hkq
fpk: xqt jpf rdm xbd
rpd: hvl
hcc: rhh vbb skp
lll: ppk qkd zqt qff
brd: prr lss gmj fxg psn
fmh: ckg
trz: lmq pzj
glb: txx ssc
lbk: dqz cmz knk bvm
phr: smx ccb tkf vkq
mkh: gzc nhc plq
jzd: nzs szx hcv
vmh: xkn spq fkf xnd zvc
jfr: xdg pnz rpp
xsz: hgr xmh
jvc: nmd qzh xxl
mbh: lhh gxf
pgv: vzb pqv
qds: mvx ksx znn dqp
lkt: csq
bsh: pzj
pbc: klz krh
qpj: vvl jmc hjx zfx nln
pjz: dsc hzc
jqs: dqb
tmx: xsj nbj
bxh: jfc xgd cmz hhl
pst: gpj mzn
dvz: pnd jrz fnb pnb rkt
dcp: dhp zjf mpl nrs
gsr: bxf vzd jdm hhl
qlb: nkq gjg pvn fbt
cch: fcs ccb rtm
mtb: mkg pnh blc cnx
nhq: pjf vbr dzf lcf
tqt: rts
nlb: ccd mxx
zgm: gpj
bbb: klv jgg xcv vgr
btd: kcr lxx crs kqr lcf mzf ljn
jmj: rdb
bzm: lcb ddz
nxv: qxx xgd hbc
fsk: ppc jlb hqx vvf
ndc: mqd tsp tcx
skp: qpv ckt
rqk: qxf
zqh: zvn
fgq: qtz xsd ggk tzk
hcq: qbz khr fxr
hql: ntq pfb gvb
zcb: xmh
rhn: mfp jjm bbq
rmt: rsq
qcn: vrk qdq stp
jnp: vtn fpd
snt: fmh pvz
dsr: blc zqt dkh
kvn: btj mjk bcb ckg
qqq: sbj klr bpz vzl
gjh: fbc bfr jss
hzn: xtc qsf
bnq: rzn vlc bhc nfs
mfl: pbl dpv gcx
khr: dbd
nrh: ktt ddz hkq
fvf: fmd rsk jtk lrz
qhf: rhh fnz jfc ggm
kvl: fvg vgx gkv bbl
tmb: pvj pbq
dlj: fpb djm
ntt: zdv bjk
qdt: mcv bjj nvb sbh
glr: lxb cxk kmz qrt jvx
mkk: zlc mgf qmb
xgq: mdv zqb
srh: fpd
jhd: xnn hsp pgd
sbn: lfx tzx tkh dgl
nln: csq
knq: nhc csc kzl nfq jrq pvj
qnz: zgm zdv xvv
spq: xbt jgp hph
mpm: pqh xdg
lfg: jnj nzs
clc: fcf
cpm: lrz mqd
hbn: qpv csq fmb
cvj: tbc nfb pfm
mnk: fmh
txx: nbk
ksb: mlf xrv
bpm: txx jkk qfl
kvb: djx
vhf: bjb
rjq: xtd
rtg: gmj
ghv: qjc
zsn: qkd gtg lst
cms: pln czp
fmv: hps spn dqp rjd vtl
rmr: pvf sfd gmn
qqt: lpx xgj ddq
svn: xxr ddz
rzz: xdg mqd ftr thf plq
zfx: xcn glt
hlx: bxl jmj vzb
vpj: qsp
kzp: stv nxf rpb
qtk: csh
mcv: sdp
ghh: jkh mbc
pdq: fcj rzs vch tsk
rtt: trp pjz zjr
fbq: drm tsj rzn cms
jrz: vvn rgh
psx: chz
spn: rbj vsb
qdr: vxn qxn pjv bsb tzz
ctv: hcn vlc ksb cpd
sdx: jff csn gsq vdb
kkl: mpl ksg xbr
mdx: fjm zlq bzv
cmk: jkr qtg qqt dgc dqm zsz
mhg: zqh bxf xmm
tmz: xcn zvx pzv
mhp: ndq pkb mfc
pxq: xmh
tsg: rpx krn ghv fxr
kzm: xqz hrt
bzs: ztq
kgz: scz rhh
xjf: nlb frf bzv bsh
pjj: vrs xnf hls
cds: qbh stv vpj
gkq: xgv klr shz
srs: ptf dpk
rgc: msm trs gsq rlf
lzc: nzc znq nfl vlm
dxh: nzm ptf hcc rlf
gsz: pvz
bsj: bng jgc
tbv: bxm qgg tss
xgv: dqp
rnn: vvl
nbk: ssc
zdd: rcb hcg tsb lxs nfq
cmq: vth rzs rbq qkx
hpd: vdn dpl hql mht
zmq: rnn zxc hnt
mgv: jkf rfh zfx rnn skf
tvf: pjh zxj dxn xdf
prg: dsz dtf
tsb: mss jtr rxv
qfj: vdn gmn mqh flq flp cnd
qfg: kkl njz jtc zjr
qsb: txm rjd gsl ggm
zng: smx zxl
jkq: vzh jjd pfs mzm gjf
srq: fxg kmb xsl lqg
cxl: kqx lcq
tsx: rhv qtp jfr hht
tbs: bjk
gmz: gnr bjf
xbd: gmn rkt
bfq: stb vrc xxr fzm
sgh: lcq dhp rkt mlt
xsd: jbx kmz
hzg: jmh kfs xdl qnf
zgq: xcr hkq
zjr: kpl
zhv: ptm pln
mmg: xqt hls lbs ndz
mpb: chd bjz lrn
lbc: lzg
smq: fdq
fxq: bbq
czl: gkr qmr
kzt: rtg vdq bnh xgh
lhb: hcv nmd
zzj: kpf cbn
vmq: crp hqx gsz
lbs: lnf
brv: cjt tdh zhg kqr mpm
fgs: mbd rqz gmn
jss: rsq cns zst hqn
hjs: kkr cnx kkq sqs mfp
rlq: dlj jgg qjt
tpt: lqs rhd frh
fcj: qrz knk pdg zmp
gcv: ftp mtl ztb qcx
sgc: vkk
mqb: gqr gnx vtm rsk txx
rnq: mmv fzd
tcq: jmj gdn
gzc: zkb
krq: stv kfh xpp rrf
vsq: mpl hqx
zcl: qqt vvf tzp
cpd: hnc
csn: lrz
tqd: nxf
vlf: rqk qgg
hvc: kbs dpf gdv hkx
gzq: qbh thf
pcv: xsd fnb ckg svn
bhc: gzc
jmh: rdb
lkh: zpx jxc bxb xcr
mqr: xkg rns rjp tqd
djc: gpl bvm mxg
hrt: sfn
cxd: dlc kqx lpc vfc
rxn: mlf vlf prf
hzb: bjz
cvs: ncg zcr
klb: bnh
qhg: vch hsr sbj njj
jbx: gcd vml
zbf: qtb dsd mlt
grx: hcb hbc znn rhv
nrs: mnk kvb hfd
bvm: nfs
rqx: thf
zvg: kmh bxv
xcq: gjb mhd
shh: mzm lvv
zpg: kcm fms
dlc: dtn gsz bdv lpc
bbv: tlc lhh
stl: cdt gjg vdb bxp
nvj: sqp nkt xhv bbq
thq: tqt vhf
gnt: fts rbl nbk bxv
tdq: qmb ddb gtm qvb
zmd: cpf tbx vjv
pjh: nll xnf jqs
nlr: gfl tzp fdh xvt
nrt: gtc xdr
qxz: cnx pmv
fcc: ktt znz fxg
gfz: ljg tlk rmt
hsr: tsp zdv jdk
msh: hrt
tnr: pms kxj ddh
gjc: qsp vkh ddh jnz
ttm: vbt lll bdv
kks: vjv pvn
nfl: tsp qvb
bxx: tjs zxl hhs nxr
qzn: qmr
xxl: tvh
gst: nzq kzp xpn
mqh: lgj cxl kfp kvb
bdh: xnf qpq mkg lbb
gnc: pzv lnl txx
lrb: pfs cnn jqs
mtr: xbt rqm ddz
gvb: fqt qxr
flp: rdk rmm fjf
mjc: pzt mxj
chs: lpp gvb fcf
xvt: ltn kzm
pgd: ssk pfm dpk
jfv: jjj rtm
qnp: blb cxk kfp cfn
xdf: hds bfh
hvn: spn hnc jdn
jrc: zmm hzn gnr
mbq: njn
glm: jmm hvf cxk vsc jtc
llv: rqm kvb ndz vdq
jgc: cgx tbc qpg
hjx: fts bpz
vkl: vxn fqm zdj spq clc
rbq: zmm xgv hrd
sbm: hcg
jtr: lcm
cjt: vfn
pgz: cds
xnj: stp
kpk: qgp ngz vkk mkg xcl
jff: nln vht xnj xgd
qdp: fkc vzd zdv hzn
zfz: jgq kxx
mbc: vcp
zcr: bxm txx ncg
zql: bjz dpk qlf
vhx: gzq lhj kcm qhg qct
zpt: blc rsq hbq bpb
drv: fjh xvv spr bnk
kcr: dvg rqk fhl
gmr: pqm mbq lzg
hqn: zzj
nsh: lcb snv jbm
kmf: pjm
sct: dqz qjx tsj
cks: crc jzd hzb xcn znn
cqc: glh srs xjp jkk tlh
qbs: dqf zmp gmz gzc lrn
hmc: lpp kmf bfr
nmg: xhr
pkb: xpf xkb kkq
bnk: gnr
ljl: ksg ztd qqg lhz
tck: xfn mvf gfz vkb
nhc: frh
xsg: jht zxq
nzq: qvb msz
ljn: qsp bnv gpj
kjn: bjf rxd qsf rzm ssl
gck: xqt zgq
qcz: ddh xrl
zsz: rgs rcp
tfc: psl
pjf: tsp
dqj: lst xhv kfq
zdm: bkg rcf vsq pcc hvm nbj
xzj: mbq bcv msm gbr
scg: fdq dqb kxx lpx
njz: rtm ckg
qqc: trl jfr vjv zmq
qct: gsl xrl
ltn: hfd ppt
znd: lcm msm pqh
gbp: zxq sgc jfx pfs
hrd: xxl
pnv: bbl mtl cgx
xmm: csh qkx
pzv: czp
nbj: fkr
xjp: ngr knk pqp
lrr: mtp rbl rpd bnk
gbr: fjh
cvc: fvz tmz mxv rdq
xsl: xpl vkb ddq
dzf: qlf
bgc: pbn zrc xgq gjh
plg: pvj jnz vzd dhl
blv: qqt cth klv xpl
ksh: trt sfs znd qcz
sdf: xxr fpb
tsq: kzp hcn zfd
tsj: xrm
jxj: jmk
bxl: qkd kdg
vcr: jfv lzv
ptm: hnt
jjl: lnm pnh
jkj: pmv dsc mcv cch
tkf: jkh ttm dnf
jnz: bsj
ndz: lxp
hzk: jqh thb kpl
vcz: gtm pkj vfn
jsn: xdh slv xpz msk
dfb: nmg hds
bxm: hbc
tlm: ksx lrz szx
snj: lkt qzn nxf hrv
lch: mdx rtt fcf
dqm: kfq stb
bkg: qff jnf pkh lvv
rpx: qnq zmp
jmr: qgg rfq mvx crc
nkq: xfr khh jmk
fjp: hpd psl rtt hbz
qjd: lnq tmb pnz gbr
dtn: vvf lhh dxp
txm: znq bpz gcx
xrq: ckj frm nkt pgx
zmm: bbl nfb xdz
hcl: hph fkd vzb
qjc: bxv mjq ccj
vvg: vmq djm lpp bmv hbl
tqj: tfc dtf jqh trz rgh xsg
kfh: phs vlm rjp
xph: bhb
bgn: fdq
kdh: frf fcf jpm cnd
tmp: sjk dsx fzd hxr
bll: tqd
pns: xnj kmh mkk trl npk
jjz: bjk
mcl: hmq lrb qrt sgc
fzm: prd mdx pnb
hjh: brq gnj lgj
jtk: tzg
qdx: kmz frf fdh xnf
dsf: qnk gxh nrs fpj
gcg: psn rfp qqp sfd
qnk: pjv fdq bhf
kkt: pqv xqt jrz rlr jjd
snr: xdz qtp vkc
nlj: fzg xxt zxj jpf
dxp: rvq
msv: bgn sbh
tsf: xfr dvg vch
sfn: mfp
rql: tbx pgz zqh
hsn: xqz spx pcb zhm
ctl: bsh mcv jpf cxr
xdz: qzh
cmt: mnk kxt cdp qtz
tsk: lkt ktk pgn
klr: bjk
sfz: knr xnf gdn sjz bmp
bhj: msk dzf
bck: qlg tzd sct pqk
gnj: vhf mfn
rxv: qpg ftp sld
xhj: gkr dlm nmf fdk
zvc: tzp mpx dbn
xtg: vms fvd nlr mcl xjz
njn: jvc
dhl: bdf qgm mqd
ssv: fhv qjx phs xtc
tqz: rtg xvp hxr ktl kfs
vgf: trb gxp nxh
jfp: xph
gqr: gnr sbm dqf
psz: ksg pvz xql
nlf: trp lhz ccb rvq
crj: tbx pst bhj
lfx: trl jmc vjv
mss: jvc svm
dtr: ktt gxt lst
spp: zsn
fbj: gbr rhh chz
pfv: pfs hlx qgp fvd tct dql
pqk: vtl pln
vjt: trs
kvm: xnd xdr
txj: gjb czl lqh tzx frh
dmc: ldk jkf ttg gzd qbh
mlc: zgd gmr xsx
bkj: tcq kvm phr nhr
jql: mdq
nmc: gqm dqf msz
fvm: qpg tsq hbx mhd xmm
mfh: zxz csd smq
nqn: zrv dfb lzh rqm spk
zns: lqr jbj vvn jfp jff
rjp: slv
jfd: qtf kfj scz vsb
ggt: kpd qtk
xtd: tgg jnf
jqj: vcr gzk mbc bbv
glh: rbj rgc sld
sbj: csh jql ckt
npk: zbl znp
hpv: bkb pxq qpq hgk
spr: sfs qzr xhh
bml: bjz rpd
ckj: jht
rpb: tcx gnr
rxc: rcs bxv vmb xrm
dpf: bzv dsx
ftx: qfh ngr plb gpl
pvj: qkp
gcd: fqt lzv
cbv: kks bjf
qgp: mcl dng
pqv: tjn dng
kfj: xbk
jkr: rmm cnd tjk
hgk: jjm pqg
vgr: pvf
tgc: vsk qhn ppl zqv pgv
qkm: xpp bhc pjf tzx lfg szr
gdx: zpg vgn cms khh dhl mrj
knr: kvt vzg fpb ppt
njj: xvv xpp rqx
bcb: pvf gfl
pgn: stv
pzt: csd
gxh: hrt fjf dcb
cfh: prd rgs kmf kzm
ckf: fxq lqx dxr klk
frq: zqb rmm smg pgv
gqn: tsk lfb vlm fdk jnz
kzh: pvn fnz hbn ckv
zxc: lbk chd szx pst
nmf: xrm rhv dqp qlg
vdn: qmj
xfn: qfr bsh xpf
sqb: lnl xgn dpv
lhm: cfk xbz
lfb: qxx jdm lxs
dcf: lhh fcc zng
xcg: vfn grx xrl qfh
gbl: crc jql tkh
mgf: rrf qtk lbc vkh
jbj: mmv thq mht nlb
lfc: jlb
dpg: hgx krn ptz qjh
dsx: prh
crl: zdd krn dqp qbz
dcb: hjh csd
xtk: tbc vtm
trb: jjd
xqg: jgg pjj tjg
nzk: svm
rzs: msk pqk
fvv: dxn xgq hbs lzh frm gzk lbh
sfp: hvl cpf ptm
mtf: drm ggm qhf tsz
ntq: dsc sdp prr
jdm: ssk
zpx: sgh
qtx: hhj tcg rvq
zpl: fqm xkb
hvf: vxd pnb xxv dpl fbd
xkn: qfr dnk hgk
thj: nmg dxp jkh bhb bzm
pkm: qjh gnx nfq
rlr: zlq jkh zxj
xjn: dtf mhp
xbt: zxq
jnj: hcv
zvx: hfk
pcc: tcg dqm
ctx: hvn tnr zdd mzn
vsc: cmf mjv
kdg: mjk dlj
bhx: tbs rpp ftx
bcz: zvn ptm znp qqc
gjg: lcf mfl
ppp: fcc vgv prg njz
qtp: qkv xhn
qtz: zbf zcb
lcs: xbt
dxn: jjl
bmp: xhr
qvm: stv vlq kpd tss
djb: mxq xjz bcb
hbz: mzq zqb dtr dsr
htj: qff bfr bsb hqx
krh: tdh tzg
